32,32
11111111111111111111111111111111
10000000000000000000000000000001
12222222222222222222222222222001
10000000000000000000000000000001
10333333333333333333333333333331
10000000000000000000000000000001
14444444444444444444444444440001
10000000000000000000000000000001
10222222222222222222222222222221
10000000000000000000000000000001
13333333333333333333333333300001
10000000000000000000000000000001
10000000000000000000000000000001
10000000000000000000000000000001
10000000000000000000000000000001
10000000000000000000000000000001
10000000000000000000000000000001
10000000000000000000000000000001
10000000000000000000000000000001
10000000000000000000000000000001
10000000000000000000000000000001
10000000000000000000000000000001
10000000000000000000000000000001
10000000000000000000000000000001
10000000000000000000000000000001
10000000000000000000000000000001
10000000000000000000000000000001
10000000000000000000000000000001
10000000000000000000000000000001
10000000000000000000000000000001
11111111111111111111111111111111
